WWWWWWWWWWWWWWWWWW
WY..V...........YW
W.RXRX.IIII.RXRX.W
W.I..I.ICCI.I..I.W
W.I..I......I..I.W
W.RXRX.YYYY.RXRX.W
W..z....HH.......W
W..F...CCCC...F..W
W................W
W..F...P......F..W
W.............O..W
W......CCCC...Z..W
W.RXRX.YYYY.RXRX.W
W.I..I.C..C.I..I.W
W.I..I.C..C.I..I.W
W.RXRX.IIII.RXRX.W
W...Z........Z...W
WWWWWWWWWWWWWWWWWW