WWWWWWWWWWWWWWWWWW
WY......O.......YW
W.IGGI......IGGI.W
W.HHHHHHHHHHHHHH.W
W.HHHHHHHHHHHHHH.W
W.IGGI......IGGI.W
W.HHHHHHHHHHHHHH.W
W................W
W.F...F...F...F..W
W...F...P...F....W
W................W
W.HHHHHHHHHHHHHH.W
W.ICCI......ICCI.W
W.HHHHHHHHHHHHHH.W
W.HHHHHHHHHHHHHH.W
W.ICCI......ICCI.W
W.......V........W
WWWWWWWWWWWWWWWWWW